#################
#**************$#
#*##*###*###*##*#
#*#$**********#*#
#*#*##*#*#*##*#*#
#******#*#******#
#*#*##*###*##*#*#
#*#**********$#*#
#*##*###*###*##*#
#$**************#
#################