11 11
###########
#$***#****#
#*##*#*##*#
#*#*****#*#
#*#*#*#*#*#
#*********#
#*#*#*#*#*#
#*#*****#*#
#*##*#*##*#
#****#***$#
###########